%%%%%%%%%
%G     .%
% .%%.% %
%P    %o%
% .%%.% %
%G     .%
%%%%%%%%%
