%%%%%%%%
%     .%
% %% %G%
%P .G% %
% %% % %
%     .%
%%%%%%%%
